012070000046125
MMMMMMMMMMMMMMMM
M$  =D         M
MMM MM M MMMMMAM
M  0   M M     M
M M M  M M M   M
M M M    $     M
M MMM  MMMMM   M
M      M  M $  M
M      $    M  M
M MMMMMM$M  M  M
M        M  M  M
M  MM M  M  M  M
M  K  M  M  M  M
M  MMMMMMM     M
M           M  M
MMMMMMMMMMMMMM M
M   k       $M M
M     $ a  # MaM
M      f   @ M M
M ### a  #1# M M
M #$#f       M$M
MMMMMMMMMMMMMMMM
M$ D     M #   M
MMMM M1M    M  M
M d    0    M =M
M   M$EM   aMMMM
M   MM        MM
M      MMM  MMMM
M     {M!M  M$=M
M*     M D  D  M
MMMMMMMMMMMMMMMM
