015084064064064
MMMMMMMMMMMMMMMM
M  *M $  $ MK  M
M MMM  MM  MMM M
M M    ##    M M
M      )(      M
M M    MM    M M
M M$   MM   $MfM
MaMMM  MM  MMM M
M  0M  MM  M0  M
M MMM ^MM^ MMM M
M M   MMMM   M M
M M M      M M M
M MAM AMM  M M M
M   M  M=  M   M
M M M $MM$ M M M
M M MMMMMMMM M M
M M          M M
MfMMMMMMMMMMMM M
M M$ k    $M1M M
M M  MMMM  M   M
M M  M$ M  MMM M
M M        # M M
M MDMMMMMMMM M M
M M      M?M M M
MMM ## M M$M M M
M$  ## M   M M M
M$     M   M M M
MMMM$  2     M M
M  MMMM MM   M M
M1      $Mu$^M^M
MMMMMMMMMMMMMMMM
