019073022095008
MMMMMMMMMMMMMMMM
M         *#$#KM
MMM MM8 ?@@####M
M  0 $M    #$#$M
M M M$M=  #####M
M M MMMMM      M
M M Ma  MMMMMMMM
M M M1    v   $M
M M MMMMMMMMM#DM
M M        1 $ 8
M MMMMMMMMM MMMM
M              M
MMMMMMMMMMMMMM M
M!  M        M M
M$M MM3MMMMM M M
MMM MM M   M M M
M  2$    M M M M
M M MM MMM M M M
M M M$4$   M M M
M M M M MMMM M M
M M M M $5 M M M
M M M M MM M M M
M M$$$M  M M M M
M MMMMMM M M M M
M MM$  # M M M M
M  M  # MM M M M
MM MMMM $M M M M
M     MMMM M M M
MEMMM      M M M
M     MMM$MM  $M
MMMMMMMMMMMMMMMM
