007091064064064
MMMMMMMMMMMMMMMM
M}             )
M### MMMMMM   KM
M### M    M    M
M### M MM    M M
M### M MMMMMMM M
M #  M M     M M
M MM$M M MMM M M
M MMMM M M$M M M
M M    M M M MAM
M MAMMMM M M M M
M M M    M$  M M
M M M MMMMM MM M
M M M M$  M    M
M M M MM MMMMM M
M M M          M
M#M MMMMMMMMMM M
M M       M$$$ M
M MMMMMMM MMMM M
M 1     M M    M
M M M M M M MM M
M M MMMEM M MM M
M MEM0M M M    M
M M M M M MMMMAM
M M     M      M
M MMMMMMMMMMMMMM
M#   #  # #    M
M  # @#  # #   M
M   # # ##  ##-0
M*     #   #   M
MMMMMMMMMMMMMMMM
