013078000014093
MMMMMMMMMMMMMMMM
M*   $         )
MMMMMM MMMMMMMEM
M   $M M# s $M M
M M MM M1  ##M M
M @  # D     M M
M M  M MMMMMMM M
M    M         M
MK!$$MMMMMMMMM M
MMMMMMM=       M
(       MMMMMMMM
M MMM MMM      M
M         # M0 M
MMMMMMMMM      M
M0    $$MMMMMMMM
M  v           M
MMMMMMMMM MMMMMM
M$          s  M
MMM MMMMMMMMMMMM
M$   A   @@@@@@M
MMAMMMMMAMMMMM@M
MM   A   M @@@@M
MMMMMMMMMM MMMMM
M     @ M   M $M
M@M       ,    M
M@MMMMMMM   MMMM
M@M#   #MMDMM=$M
M@M$     #     M
M@MMMMMMMMMMMMMM
M@@@@@@@@@@@#E$M
MMMMMMMMMMMMMMMM
