024086064064064
MMMMMMMMMMMMMMMM
M M           KM
M M $MMMMMMMMMMM
M M$$MA       AM
M M$A   M   #  M
M MM    M  M M M
M =M    M  MaMAM
M  # $  M  M M M
MMMM M  M #M M M
MA   M MM  M MAM
M MMMM M*  M M M
M M        M M M
MA  MM  MM MMMAM
M M  MMMM      M
M M        MMM M
M MM # #MM $M  M
M              M
MMMMMMMMMMMMMM$M
M!             M
M$MMMMMMMMMMMMMM
M              M
MMMMMMMMMMMMMM$M
M $$#$#$#$#$#  M
(              M
M MMMMMMMMMMM  M
M MM$ $Dk#     M
M $MMMMM#    @ M
M MM           M
M %%%%%%%%%%%%%M
M  $#$#$#$#$#$#M
M^MMMMMMMMMMMMMM
