006075001078157
MMMMMMMMMMMMMMMM
M              M
M MMMMMMMMMMMM M
M M  A $  KM M M
M MDMMMMMMMM M M
M M  ###   M M M
M M  #$#AM M M M
M M  ###   M M M
M M        < M M
M M   M  M M M M
M MM    MM M M M
M MMM  MM  M M M
M M MM     ? M M
M #    MMM M M M
M M      #     M
M M MMM MMMMMM M
M M     $    ) M
M M !MMMMMMM M M
M M   M=M    M M
M MAM MaM M #M M
M M M M MEM #M M
M M MA    M  M M
M M M MMM ME#M M
M M M     M #M M
M MAM EMMMM  M M
M M         #M M
M M@MMM MMMMMMMM
M M$$ D D $$=MEM
M MMMMMMMMMMMM M
M*             M
MMMMMMMMMMMMMMMM
