004074064064064
MMMMMMMMMMMMMMMM
M*M   M    MKM!M
M M M #  0     M
M       )##    )
MMMM ^MMM  MMM%M
M       M  M 1%M
M  ##     MM M%M
M# M $ ME M #M%M
M  MMM M  M  M M
M #M   M  M  M M
M  M MMM  M #! M
M  M $ M  M# M M
M #M M M  M  M M
M  M M M  M  M^M
M @M M M  M MMMM
M  M      M v  M
M MMMMM#MMMMMM#M
M M 0 M M?@ v  M
M M M M M $MMM M
M M M M M M #  M
M M M M M  M#M M
M M MaM M      M
M MuM M M  #M$ M
M MMM M M   MMMM
M M M M M #   ?M
M M M1M MMMMMMMM
M#M MMM M%%@ $#M
M    )M %%%%%@ M
M$  # M @MMMM %M
M   M         %M
MM^MMMMMMMMMMMMM
