011082000031000
MMMMMMMMMMMMM0MM
M*     MMMMM   M
MMMMM/     M M M
M=    MMMM M MAM
MMMMM      M M M
M   M MMMMMM   M
M   M M       <M
M M MDM MMMMMMMM
MEM     M##$ #!M
M $ M MMM$# @##M
M   M         {M
MMMMMDMMMMMMMMMM
M#       a   MMM
M  # # #       M
M ##MMMMM fM M$M
M  #$M= MMMM#M M
M @  M       M M
MM   MAMAMMM M$M
MMMMMM M     D M
M   M$ M M M MMM
M  #D    M    #M
M# #M MM MMMM #M
M  #M M        M
MK $M MAMMMMM #M
MMMMM M     M #M
M           M #M
M M MMMMMMM MA#M
M M#  v  =M   #M
M M@MMMMMMM M $M
M M$        # $M
M0MMMMMMMMMMMMMM
