005087006090084
MMMMMMMMMMMMMMMM
M$# $M=   M#  $M
M   #M# # M    M
M### M #  M M  M
M  # M# # M MDMM
1 ## M ###M## #M
M####M         <
>              M
MMMMMMMMM MMMMMM
M*             M
MMMMMM MMMMMM MM
M        MMM   M
M -MMM M M$MM MM
M    MuM   MM MM
MMMM0MMM M MMuMM
M      M    MMMM
M      M       M
M = $  M  v    M
MA    AM  a MMMM
M A    M    D KM
MMMM1MMMMMMMMMMM
M    #         0
M       M  #   M
M M   M MMM    M
M MMMMM M #    M
M M$  M    MM  M
MEM M M  M #   M
M M M M MM @M  M
M M M M o      M
M              M
MMMMMMMMMMMMMMMM
