006097047095000
MMMMMMMMMdMMMMMM
M    M    M    M
M *  D  M M  $ M
M    M $M ##   M
M    M MM M##  M
MMM  MMMM MMMMMM
M @@ M    M    M
M    M    M  $ M
M    #  1 M    M
M#   M    M   #M
MMMM^MMMMMMMDMMM
M         M   #M
M MMMMMMM M 1  M
M ?    #M M    M
M    $  M M    M
M   2   M MMM MM
M     = MEM ## M
M       M M $  M
M MMMMMMM M# # M
M         M  #=M
MMMMMMMMMMM@MMMM
M$=a      M    M
MMM M M M   MM M
M    K    M #A M
M M M M M M MM M
M M   v   M  # M
M M MMMMMMM MM M
M M M D   M    M
M M M M ! MMMM M
M     M   M2   M
MMMMMMMMMMMMMMMM
