009083064064064
MMMMMMMMMMMMMMMM
M=D$MMM M   M MM
M[#           aM
M[#@MMM MMMM  aM
M[#@    M$$M MaM
M[#!       M   M
M   M      M$  )
M M MMMMM    M M
M M          M M
M MAMMMM MMM MMM
M M M #        M
M M M    MMMMM M
M M M  M M E   M
M M MM $   A   M
M M  M   MMMMM M
M M    M       M
M MM$  M       M
M  MM  M MMMMM M
M  M       E   M
M     M v   $M M
M MAM MMMMMM M M
M   M        M M
M   M    MM  M M
MMMMMMMM# M MM M
M @       M*M$ M
M%%%%%o%%%M#M  M
M%%%%%% %%M    M
M%%%%%%%%%M  MMM
M  -       ? MKM
M            D$M
MMMMMMMMMMMMMMMM
