008071096096096
MMMMMMMMMMMMMMMM
M  s  v    M$#0)
M #MM       M# M
M       M MM   M
M M MMM M@  A  M
M M       M MM M
M MMMM MM M  M M
M  M    M M    M
M      EM   MM M
MM   M  M      M
M  M M    MMM  M
M AM      M    M
M  MM M M     MM
M ? M   M      M
M   M       MMMM
M?? M MMMMM@ MqM
M     M   M  M M
M ? M        M M
M   M  MMMMMMM M
MM MMMMM     $ M
M# $?M  EMMM   M
M###KM MMM MME M
M  MMM         M
MMM0     M@M $ M
M MMMMMMMM MMM M
M              )
M MMMMMMMMMMMM$M
M #!##  # # *D$M
M#  #  ##  # M$M
M=  # #  ## #M$M
MMMMMMMMMMMMMMMM
