008094001078157
MMMMMMMMMMMMMMMM
M              M
M  MMM MDM M MEM
M  M A M=M M$M M
M AMMM MM  EM  M
M   $M M$M  M  M
M  MMM MDM  M KM
M             =M
M*MMMMMMMMMMMMMM
>              M
MMMMMMMMMMMMMM M
M       #DDD   <
M #MMMMMMMMM   M
M# M0      M   M
M #M     M M o M
M  M A   M M   M
M #M MMMMM M @MM
M# M       M   M
M  M     M M   M
M# M E   M M  MM
M #M MMMMM M@# M
M  M       M#  M
M #M M   M M   M
M  M M$M$M M   M
M  M MMMMM M @ M
M##M       M M M
M  M MMMMM M @ M
M  M A$M$A M#  M
M  M MMMMM M # M
M0 M       M #$M
MMMMMMMMMMMMMMMM
