009090000046125
MMMMMMMMMMMMMMMM
M   =####   ###M
MAK # v   #    M
M   MMMMMMMMMM M
MMMMM M    v M M
M   MaM !?   M M
M M$M M    { M M
M M M MMM MMaM M
M #0     1M$ M M
M M MM MM MM M M
M    M$M   M M M
M    MMMs    M M
MMM    MM M MM M
M$M  # MM  2   M
M MMM MM$ M M$^M
M    3      MMMM
M MMM MMM      M
M       M   MM M
MM MM   MMM $M M
M   MMM   M MM M
MMM       M    M
M>           M M
MM MMMMM  MM M M
MM        <M M M
MMMM  MM MMM M M
M $M MM        M
M  M M$AMM MMMMM
M ?M M     M   M
M  # MMMMM M M M
M  D M s     M*M
MMMMMMMMMMMMMMMM
