010095096096096
MMMMMMMMMMMMMMMM
M    #    M  ==M
MDM  ##   D  E M
M M MMMM MMMMMMM
M$M   M       MM
M$M M E #     MM
MMM MM   M @ @ M
MM   @ M#MM E  M
MM  AMM$  MMMMMM
M    M}       #M
MM MMMM$M#MMMM#M
M? D=KMM  M    M
M!AMMMMM #M  # M
M#        M #$ M
M$MDMMMM  M##MMM
MMM    MM$M  M=M
MdM MM  MMM$ D M
M M EMMEM$MMMM M
M     M        M
M MMM MMMMMMMM M
M     E        M
M$MMMMMMMMMMMMMM
M           M MM
M  MMMMMMM     M
(# #$#M     M  M
M ####M     M  M
M  MMMM MMM M@ M
M         M M  M
MMDMMMMMM   MMMM
M   =$  D     *M
MMMMMMMMMMMMMMMM
