009068064064064
MMMMMMMMMMMMMMMM
M        a D  =M
M M M MaM MM   M
M MaM M M MMM1MM
M M MaM M M$ #=M
M MMMMMMMMM ?  M
M              M
Ma MMMMMMMMMMM M
M  M$        M M
M  M         D M
M  M    A    M M
M  MMMMMMMMMMM M
M>             M
M##### @@ #####M
M # #      # # M
M$ # #  = # # $M
MMMMMMMMMMMMMMMM
M       v     #M
M MMM @#MMMM dqM
M#M     M$!M   M
M1M    MM  M## M
M#     M  fM#$ M
M$   MMM   MM $M
M#   M     M   M
M0MMMM AM  M#@?M
M  #   M   M   M
M # #      MDMMM
M  #  #       DM
MMMMM MMMM MMMDK
M= v  M*$  s   M
MMMMMMMMMMMMMMMM
