015098000046125
MMMMMMMMMMMMMMMM
MK*     M     $M
MMMMMAM    M E M
M     M  MMMMM M
M  MMMMM    M  M
M    MA     M MM
M$ M M   $MEM MM
MMMM     MM   MM
M!MMMMMMMM    MM
M     #  # MMMMM
MEM M          M
M   MAMMM   MM M
MMMMM   MMMMM$AM
M     M        M
M#MM$MMMMMMMMMMM
M              )
M  M MMMMMMMMMMM
MM            $M
MMMM MMMM@MMM MM
M$$M           M
M #M^MMMM $MM  M
M  M    MMMM$ MM
M  M#M  M      M
M# M$M  M      M
M #MMM  M AMMMAM
M   MM  M      M
MA#AM          M
M M MM  M   $$ M
M A    EMMM $$ M
M   ##         M
MMMMMMMMMMMMMMMM
