008070000046125
MMMMMMMMMMMMMMMM
M}     $M      M
M   #$  M  a * M
M !    )M#     M
M       M   MMMM
MMM(        @ #M
M       M     #M
M MMMMM M     #M
M$ A   $M     #M
MMMMMMMMMMMMMM#M
M            M M
M MMMMMM M 0 M M
M    E)M M   M M
M MMMMMM MMMMM M
M M(E    M     M
M MMMMMM M#    )
M        M  #  M
M MMMMMMMM   MMM
M M    M(     )M
M M  1 MMMMM MMM
M M  A M d M   M
M M $# M   M   M
M          M 1 M
MMM2MMMM   M   M
M      M   MMMMM
M $    M   M   M
M      MMDMM 0 M
M     EM A M   M
M    $ M K M $ M
M =    M   M   M
MMMMMMMMMMMMMMMM
