017076064064064
MMMMMMMMMMMMMMMM
M              M
M  EM    MMMA  M
M  $M=   M= #  M
M  MMM   MMM   M
M$            *M
MDMMMMMMMMMMMMMM
MD      D      M
MM  MMM M      M
MM  ?vM M $$$$ M
MMAMMMMAMEMMMM M
MM #MMM M $$$$ M
MM  = M M MMMM M
MM #MMM M $$$$ M
MM MMMM MEMMMM M
MM      M      M
MMMMMMMMMMMMMM0M
MK     k       M
M          MM& M
M   &   #   M  M
M    ?      MM M
MMMM(    $  $M M
M          MMM M
M     &        M
M  &   {u  &   M
M      d}      M
M           &  M
M& $    ??     M
MMMMMMM        M
M0 !     &     M
MMMMMMMMMMMMMMMM
